25 20
       #########
    #####.....#####
  ###.............###
 ###...s.......s...###
##...t...#####...t...##
#.......##qlq##.......#
#......##  b  ##......#
#....w##   .   ##w....#
#.....##   .   ##.....#
#.....##   .   ##.....#
#.....d.........d.....#
#.....##       ##.....#
#.....##       ##.....#
#......##     ##......#
#.......##   ##.......#
##...t...#####...t...##
 ###...s.......s...###
  ###.............###
    #####..@..#####
       #########
